       ||||||||||||||||||||||||||||||||||||       
       ||||||||||||||||||||||||||||||||||||       
       ||||||||||||||||||||||||||||||||||||       
       ||        ||     ||     ||         O        
       |||||  || |||||| || ||  ||||||||| ||       
       |||||| || |||||| || ||  ||||||||| ||       
       || ||| ||     ||    ||            ||       
       || ||| |||||  || ||||||||||||  |||||       
       || ||| |||||  || |||||||||||| ||||||       
       || |||    ||     ||     ||    ||| ||       
       || ||     ||     ||     ||     || ||       
       || |||||| ||||||||| ||||||||||||| ||       
       || |||||| ||||||||| ||||||||||||| ||       
       ||     ||        || ||     ||     ||       
       || |||||||||  ||||| ||  || |||||| ||       
       || |||||||||  ||||| ||  || |||||| ||       
       || ||         ||    ||  ||        ||       
       || ||| ||||||||| |||||  || ||  |||||       
       || ||| ||||||||| |||||  || ||  |||||       
       || ||| ||||||||| |||||  || || ||||||       
       || ||     ||  ||        || || ||| ||       
       || |||||| ||  ||||| |||||| || ||| ||       
       || |||||| ||  ||||| |||||| || ||| ||       
       ||                         || ||| ||       
       ||||||||| ||  ||||| ||||||||| ||| ||       
       ||||||||| ||  ||||| ||||||||| ||| ||       
       ||        ||  || || ||            ||       
       ||        ||  || || ||            ||       
       || |||||| ||  || || ||  || |||||||||       
       || |||||| ||  || || ||  || |||||||||       
       || ||         ||        || ||     ||       
       || |||||||||  || |||||  ||||| ||| ||       
       || |||||||||  || |||||  ||||| ||| ||       
       X                   ||        ||| ||       
       ||||||||||||||||||||||||||||||||||||       
       ||||||||||||||||||||||||||||||||||||       
       ||||||||||||||||||||||||||||||||||||       